R 640 400
NO ./texture/noo.xpm
SO ./texture/soo.xpm
WE ./texture/wee.xpm
EA ./texture/eaa.xpm
S ./texture/bird.xpm

C 225,30,0
F 220,100,0


        1111111111111111111111111
        1000000000110000000000001
        1011000001110000002000001
        1001000000000000000000001
111111111011000001110000000000001
100000000011000001110001111111111
11110111111111011100000020001
11110111111111011101010000001
11000000110101000000000200001
10002000000000001100000000001
10000000000000001101010000001
11000001110101011100000000N0111
11110111 1110101 101111010001
11111111 1111111 111111111111
